숫자
    숫자 자료형
        - 소수점이 없는 정수형
        - 소수점이 있는 실수형 (부동 소수점)이 있음
    숫자 연산자 : 사칙연산자, // (정수 나누기 연산자), % (나누기 연산자), ** (제곱 연산자) 등이 있음
    연산자 : 우선순위가 존재하는데, 곱하기와 나누기가 가장 우선이고 더하기와 빼기가 다음으로, 잘 모를 때는 괄호를 입력해 나타냄
    복합 대입 연산자 : 기본 연산자와 =연산자를 함께 사용해 구성함

변수와 입력
    변수 : 값을 저장할 때 사용하는 식별자(모든 자료형 가능)
    변수 선언 : 변수를 생성하는 것을 의미
    변수 할당 : 변수에 값을 넣는 것을 의미(변수 = 값)
    변수 참조 : 변수에서 값을 꺼내는 것

    input() 함수 : 명령 프롬프트에서 사용자로부터 데이터 입력받음(항상 문자열)
        - 프롬프트 함수 : input 함수 괄호 안에 입력한 내용
        - 블록(Block) : 프로그램이 실행 중 잠시 멈추는 것
    int() 함수 : 문자열을 int 자료형으로 변환
    float() 함수 : 문자열을 float 자료형으로 변환
    str() 함수 : 숫자를 문자열로 변환
    
숫자와 문자열의 다양한 기능
    format() 함수 : 숫자와 문자열을 다양한 형태로 출력함
        - 중괄호 포함한 문자열 뒤에 마침표 찍고 format() 함수를 사용함(중괄호 개수 = 함수 안 매개변수 개수)
    upper() 및 lower() 함수 : 문자열의 알파벳을 대문자 혹은 소문자로 변경함
    strip() 함수 : 문자열 양옆의 공백을 제거함
    
    [True/False]
    isalnum() : 알파벳 또는 숫자로만 구성되어 있는지 확인
    isalpha() : 알파벳으로만 구성되어있는지 확인
    isidentifier() : 식별자로 사용할 수 있는지 확인
    isdecimal() : 정수 형태인지 확인
    isdigit() : 숫자로 인식될 수 있는 것인지 확인
    isspace() : 공백으로만 구성되어 있는지 확인
    islower() : 소문자로만 구성되어 있는지 확인
    isupper() : 대문자로만 구성되어 있는지 확인

    find() 함수 : 문자열 내부에 특정 문자가 어디에 위치하는지 찾을 때 사용함
    in 연산자 : 문자열 내부에 어떤 문자열이 있는지 확인할 때 사용함
    split() 함수 : 문자열을 특정한 문자로 자를 때 사용함
    f-문자열 : 문자열 안에 값을 format() 함수보다 간단하게 삽입함

ValueError
    - 변한할 수 없는 것을 변환하려 하는 경우
    - 숫자가 아닌 것을 숫자로 번환하려 하는 경우
    - 소수점이 있는 숫자 형식의 문자열을 int() 함수로 변환하려 하는 경우